...#.C..#.
.C..#...C#
.....C..#.
.CC#C#....
.C##..##..
